64 64 64 64 64 64 64 64 64 64 64 64 64 64 64 64 64 64 46 46 46 46 65 45 45 46 45 45 45 45 45 45 46 45 45 46 45 46 45 45 46 46 45 46 45 45 65 57 57 57 
64 64 64 64 64 64 64 64 64 64 64 64 64 64 64 64 64 64 46 46 46 46 65 45 46 45 46 45 45 46 45 45 45 45 45 45 45 45 47 45 45 46 45 46 45 45 65 57 57 57 
64 64 64 64 64 64 64 64 64 64 64 64 64 64 64 64 64 46 46 46 46 46 65 45 45 45 46 45 45 45 45 45 45 45 46 45 46 45 45 45 45 45 45 45 46 45 65 57 57 57 
64 64 64 64 64 64 64 64 64 64 64 64 64 64 64 64 64 46 46 46 46 46 65 65 65 65 65 65 65 45 45 46 45 45 46 45 45 45 45 46 46 45 45 46 45 45 65 57 57 57 
64 64 64 64 64 64 64 64 64 64 64 64 64 64 64 64 46 46 46 46 46 46 46 46 46 46 46 46 65 45 45 45 45 46 45 45 46 45 46 45 45 46 45 45 45 46 65 57 57 57 
64 64 64 64 64 64 64 64 64 64 64 64 64 64 64 46 46 46 46 46 46 46 46 46 46 46 46 46 65 45 46 45 45 45 45 45 46 45 46 45 45 45 45 46 45 45 65 57 57 57 
64 64 64 46 46 46 46 46 46 46 46 46 46 46 46 46 46 46 46 46 46 46 46 46 46 46 46 46 65 65 65 65 45 46 46 45 45 45 45 45 45 46 45 45 65 65 65 57 57 57 
64 64 46 46 46 46 46 46 46 46 46 46 46 46 46 46 46 46 46 46 46 46 46 46 46 46 46 46 46 46 46 65 45 45 45 45 46 45 46 46 45 46 45 45 65 57 57 57 57 57 
64 64 46 46 46 46 46 46 46 46 46 46 46 46 46 46 46 46 46 46 46 46 46 46 46 46 46 46 46 46 46 65 65 65 65 45 46 45 45 45 46 45 46 45 65 57 57 57 57 46 
64 46 46 46 46 46 46 46 46 46 46 46 46 46 46 46 46 46 46 46 46 46 46 46 46 46 46 46 46 46 46 46 46 46 65 45 45 46 45 45 45 45 45 45 65 57 57 57 46 46 
64 64 46 46 46 46 46 46 46 46 46 46 46 46 46 46 46 57 57 57 57 57 57 57 57 57 46 46 46 46 46 46 46 46 65 65 65 65 45 46 45 46 45 65 65 57 57 57 46 46 
64 46 46 46 46 46 46 46 46 46 46 46 46 46 46 46 46 57 57 57 57 57 57 57 57 57 57 57 46 46 46 46 46 46 46 46 46 65 45 45 45 45 65 65 57 57 57 46 46 46 
46 46 46 46 46 46 46 46 46 46 46 46 46 46 46 46 57 57 57 57 57 57 57 57 57 57 57 57 57 46 46 46 46 46 46 46 46 65 65 45 46 65 65 57 57 57 57 46 46 46 
46 46 46 46 46 46 46 46 46 46 46 46 46 46 46 46 57 57 57 57 57 62 62 62 62 62 62 57 57 57 57 57 57 46 46 46 46 57 57 57 57 57 57 57 57 57 46 46 46 46 
46 46 46 46 46 46 46 46 46 45 46 46 46 46 46 57 57 57 57 57 62 62 62 62 62 62 62 62 57 57 57 57 57 57 57 57 57 57 57 57 57 57 57 57 57 46 46 46 46 46 
46 46 46 46 46 46 46 46 46 46 46 46 46 46 46 57 57 57 62 62 62 62 62 62 62 62 62 62 62 62 62 62 57 57 57 57 57 57 57 57 57 57 57 57 46 46 46 46 46 46 
46 46 46 46 46 46 46 46 46 46 46 46 46 46 57 57 57 62 62 62 62 62 62 62 62 62 62 62 62 62 62 62 62 57 57 57 57 57 57 57 57 57 57 46 46 46 46 46 46 46 
64 64 64 64 64 64 64 64 64 64 64 64 64 57 57 57 62 62 62 62 62 62 62 75 75 75 75 75 62 62 62 62 62 62 62 57 57 57 57 57 57 57 46 46 46 46 46 46 46 46 
64 64 64 64 64 64 64 64 64 64 64 64 64 57 57 57 62 62 62 62 62 62 75 75 75 75 75 75 75 75 75 75 62 62 62 62 62 57 57 57 57 46 46 46 46 46 46 46 46 46 
64 64 64 64 64 64 64 64 64 64 64 64 64 57 57 57 62 62 62 62 62 75 75 75 75 75 75 75 75 75 75 75 75 62 62 62 62 62 62 62 46 46 46 46 46 64 64 64 64 64 
64 64 64 64 64 64 64 64 64 64 64 64 57 57 57 62 62 62 62 62 75 75 75 75 75 75 75 75 75 75 75 75 75 75 75 62 62 62 62 62 46 46 46 64 64 64 64 64 64 64 
64 64 64 64 64 64 64 64 64 64 64 64 57 57 57 62 62 62 62 62 75 75 75 75 75 75 75 75 75 75 75 75 75 75 75 75 75 62 62 62 62 46 46 64 64 64 64 64 64 64 
64 64 64 64 64 64 64 64 64 64 64 57 57 57 57 62 62 62 62 62 75 75 75 75 75 75 75 75 75 75 75 75 75 75 75 75 75 62 62 62 62 64 64 64 64 64 64 64 64 64 
64 64 64 64 64 64 64 64 64 64 64 57 57 57 57 62 62 62 62 62 75 75 75 75 75 75 75 75 75 75 75 75 75 75 75 75 75 62 62 62 62 64 64 64 64 64 64 64 64 64 
64 64 64 64 64 64 64 64 64 64 64 57 57 57 57 62 62 62 62 62 75 75 75 75 75 75 75 75 75 75 75 75 75 75 75 75 62 62 62 62 64 64 64 64 64 64 64 64 64 64 
65 65 65 65 65 65 65 65 64 64 64 57 57 57 57 62 62 62 62 62 75 75 75 75 75 75 75 75 75 75 75 75 75 62 62 62 62 62 62 64 64 64 64 64 64 64 64 64 64 64 
65 22 44 44 44 44 22 65 64 64 64 57 57 57 57 62 62 62 62 62 75 75 75 75 75 75 75 75 75 75 75 75 62 62 62 62 62 62 64 64 64 64 64 64 64 64 64 64 64 64 
65 44 44 44 44 44 44 65 64 64 64 57 57 57 62 62 62 62 62 62 75 75 75 75 75 75 75 75 75 75 75 75 62 62 62 62 62 64 64 64 64 64 64 64 64 64 64 64 64 64 
65 44 44 44 44 44 44 65 64 64 57 57 57 62 62 62 62 62 62 62 75 75 75 75 75 75 75 75 75 75 75 62 62 62 62 64 64 64 64 64 64 64 64 64 64 64 64 64 64 64 
65 44 44 44 44 44 44 65 64 64 57 57 57 62 62 62 62 62 62 62 75 75 75 75 75 75 75 75 75 75 75 62 62 62 62 64 64 64 64 64 64 64 64 64 64 64 64 64 64 64 
65 44 44 44 44 44 44 65 57 57 57 57 57 62 62 62 62 62 62 62 75 75 75 75 75 75 75 75 75 75 75 62 62 64 64 64 64 64 64 64 64 64 64 64 64 64 64 64 64 64 
65 44 44 44 44 44 44 65 57 57 57 57 57 62 62 62 62 62 62 62 75 75 75 75 75 75 75 75 75 75 62 62 64 64 64 64 64 64 64 64 64 64 64 64 64 64 64 64 64 64 
65 44 44 44 44 44 44 65 57 57 57 57 62 62 62 62 62 62 62 75 75 75 75 75 75 75 75 75 75 62 62 62 64 64 64 64 64 64 64 64 64 64 64 64 64 64 64 64 64 64 
65 65 65 65 44 65 65 65 57 57 57 62 62 62 62 62 62 62 62 75 75 75 75 75 75 75 75 75 75 62 62 64 64 64 64 64 64 64 64 64 64 64 64 64 64 64 64 64 64 64 
57 57 57 57 57 57 57 57 57 57 57 62 62 62 62 62 62 62 62 75 75 75 75 75 75 75 75 75 75 62 62 64 64 64 64 64 64 64 64 64 64 64 64 64 64 64 64 64 64 64 
57 57 57 57 57 57 57 57 57 57 62 62 62 62 62 62 62 62 62 75 75 75 75 75 75 75 75 75 62 62 62 64 64 64 64 64 64 64 64 64 64 64 64 64 64 64 64 64 64 64 
57 57 57 57 57 57 57 57 57 57 62 62 62 62 62 62 62 62 75 75 75 75 75 75 75 75 75 62 62 62 62 62 64 64 64 64 64 64 64 64 64 64 64 64 64 64 64 64 64 64 
57 57 57 57 57 57 57 57 57 62 62 62 62 62 62 62 62 75 75 75 75 75 75 75 75 75 75 62 62 62 62 62 62 64 64 64 64 64 64 64 64 64 64 64 64 64 64 64 64 64 
57 57 57 57 57 57 57 57 62 62 62 62 62 62 62 62 75 75 75 75 75 75 75 75 75 75 75 62 62 62 62 62 62 62 64 64 64 64 64 64 64 64 64 64 64 64 64 64 64 64 
62 62 62 62 62 62 62 62 62 62 62 62 62 62 62 62 75 75 75 75 75 75 75 75 75 75 75 75 62 62 62 62 62 62 62 64 64 64 64 64 64 64 64 64 64 64 64 64 64 64 
62 62 62 62 62 62 62 62 62 62 62 62 62 62 62 62 75 75 75 75 75 75 75 75 75 75 75 75 62 62 62 62 62 62 62 62 64 64 64 64 64 64 64 64 64 64 64 64 64 64 
62 62 62 62 62 62 62 62 62 62 62 62 62 62 62 75 75 75 75 75 75 75 75 75 75 75 75 75 75 62 62 62 62 62 62 62 62 64 64 64 64 64 64 64 64 64 64 64 64 64 
62 62 62 62 62 62 62 62 62 62 62 62 62 62 62 75 75 75 75 75 75 75 75 75 75 75 75 75 75 75 62 62 62 62 62 62 62 62 64 64 64 64 64 64 64 64 64 64 64 64 
62 62 62 62 62 62 62 62 62 62 62 62 62 62 62 75 75 75 75 75 75 75 75 75 75 75 75 75 75 75 62 62 62 62 62 62 62 62 62 64 64 64 64 64 64 64 64 64 64 64 
62 62 62 62 62 62 62 62 62 62 62 62 62 62 75 75 75 75 75 75 75 75 75 75 75 75 75 75 75 75 75 62 62 62 62 62 62 62 62 62 62 64 64 64 64 64 64 64 64 64 
62 62 62 62 62 62 62 62 62 62 62 62 62 75 75 75 75 75 75 75 75 75 75 75 75 75 75 75 75 75 75 75 62 62 62 62 62 62 62 62 62 62 64 64 64 64 64 64 64 62 
62 62 62 62 62 62 62 62 62 62 62 62 62 75 75 75 75 75 75 75 75 75 75 75 75 75 75 75 75 75 75 75 75 62 62 62 62 62 62 62 62 62 62 62 62 62 62 62 62 62 
62 62 62 62 62 62 62 62 62 62 62 62 62 75 75 75 75 75 75 75 75 75 75 75 75 75 75 75 75 75 75 75 75 75 75 62 62 62 62 62 62 62 62 62 62 62 62 62 62 62 
62 62 62 62 62 62 62 62 62 62 62 62 75 75 75 75 75 75 75 75 75 75 75 75 75 75 75 75 75 75 75 75 75 75 75 75 75 62 62 62 62 62 62 62 62 62 62 62 62 62 
62 62 62 62 62 62 62 62 62 62 75 75 75 75 75 75 75 75 75 75 75 75 75 75 75 75 75 75 75 75 75 75 75 75 75 75 75 75 62 62 62 62 62 62 62 62 62 62 62 62 
